Like a Rolling Stone	Боб Дилан
(I Can’t Get No) Satisfaction	The Rolling Stones
Imagine	Джон Леннон
What’s Going On	Марвин Гэй
Respect	Арета Франклин
Good Vibrations	The Beach Boys
Johnny B. Goode	Чак Берри
Hey Jude	The Beatles
Smells Like Teen Spirit	Nirvana
What’d I Say	Рэй Чарльз
My Generation	The Who
A Change Is Gonna Come	Сэм Кук
Yesterday	The Beatles
Blowin’ in the Wind	Боб Дилан
London Calling	The Clash
I Want to Hold Your Hand	The Beatles
Purple Haze	The Jimi Hendrix Experience
Maybellene	Чак Берри
Hound Dog	Элвис Пресли
Let It Be	The Beatles(запись и выпуск сингла), Фил Спектор (ремикс и выпуск песни на альбоме)
Born to Run	Брюс Спрингстин
Be My Baby	The Ronettes
In My Life	The Beatles
People Get Ready	The Impressions
God Only Knows	The Beach Boys
(Sittin’ on) The Dock of the Bay	Отис Реддинг	1968	▲ 2	Стив Кроппер
Layla	Derek and the Dominos
A Day in the Life	The Beatles
Help!	The Beatles
I Walk the Line	Джонни Кэш
Stairway to Heaven	Led Zeppelin
Sympathy for the Devil	The Rolling Stones
River Deep – Mountain High	Айк Тёрнер и Тина Тёрнер
You’ve Lost That Lovin’ Feelin’	The Righteous Brothers
Light My Fire	The Doors
One	U2
No Woman, No Cry	Боб Марли и The Wailers
Gimme Shelter	The Rolling Stones
That’ll Be the Day	Бадди Холли и The Crickets
Dancing in the Street	Martha and the Vandellas«Микки» Стивенсон
The Weight	The Band
Waterloo Sunset	The Kinks
Tutti Frutti	Литл Ричард
Georgia on My Mind	Рэй Чарльз
Heartbreak Hotel	Элвис Пресли
Heroes	Дэвид Боуи
All Along the Watchtower	The Jimi Hendrix Experience	1968	▲ 1	Джими Хендрикс
Bridge Over Troubled Water	Simon & Garfunkel
Hotel California	Eagles
The Tracks of My Tears	Смоки Робинсон и The Miracles
The Message	Grandmaster Flash and the Furious Five
When Doves Cry	Принс
When a Man Loves a Woman	Перси Следж	1966	▲ 1	Марлин Грин, Куин Айви
Louie Louie	The Kingsmen	1963	▲ 1	Кен Чэйс
Long Tall Sally	Литл Ричард	1956	▲ 1	Роберт Блэкуэлл
Anarchy in the UK	Sex Pistols
A Whiter Shade of Pale	Procol Harum
Billie Jean	Майкл Джексон
The Times They Are a-Changin’	Боб Дилан
Let’s Stay Together	Эл Грин
Whole Lotta Shakin’ Goin’ On	Джерри Ли Льюис
Bo Diddley	Бо Диддли
For What It’s Worth	Buffalo Springfield
She Loves You	The Beatles
Sunshine of Your Love	Cream
Redemption Song	Боб Марли и The Wailers
Jailhouse Rock	Элвис Пресли
Tangled Up in Blue	Боб Дилан
Crying	Рой Орбисон
Walk On By	Дайон Уорвик
Papa’s Got a Brand New Bag	Джеймс Браун	1966	▲ 1	Джеймс Браун
California Girls	The Beach Boys
Superstition	Стиви Уандер	1972	▲ 1	Стиви Уандер, Малкольм Сесил, Роберт Маргулефф
Summertime Blues	Эдди Кокран
Whole Lotta Love	Led Zeppelin
Strawberry Fields Forever	The Beatles
Mystery Train	Элвис Пресли
I Got You (I Feel Good)	Джеймс Браун
Mr. Tambourine Man	The Byrds
You Really Got Me	The Kinks	1964	▲ 2	Шел Талми
I Heard It Through the Grapevine	Марвин Гэй
Blueberry Hill	Фэтс Домино
Norwegian Wood (This Bird Has Flown)	The Beatles
Every Breath You Take	The Police
Crazy	Пэтси Клайн
Thunder Road	Брюс Спрингстин
Ring of Fire	Джонни Кэш
My Girl	The Temptations
California Dreamin'	The Mamas and The Papas
In the Still of the Night	The Five Satins
Suspicious Minds	Элвис Пресли
Blitzkrieg Bop	Ramones
I Still Haven’t Found What I’m Looking For	U2
Good Golly Miss Molly	Литл Ричард
Blue Suede Shoes	Карл Перкинс
Great Balls of Fire	Джерри Ли Льюис
Roll Over Beethoven	Чак Берри
Love and Happiness	Эл Грин
Fortunate Son	Creedence Clearwater Revival
Crazy	Gnarls Barkley
You Can’t Always Get What You Want	The Rolling Stones
Voodoo Child (Slight Return)	The Jimi Hendrix Experience
Be-Bop-A-Lula	Джин Винсент и Blue Caps
Hot Stuff	Донна Саммер
Living for the City	Стиви Уандер
The Boxer	Simon & Garfunkel
Mr. Tambourine Man	Боб Дилан
Not Fade Away	Бадди Холли и The Crickets
Little Red Corvette	Принс
Brown Eyed Girl	Ван Моррисон
I’ve Been Loving You Too Long (To Stop Now)	Отис Реддинг
I’m So Lonesome I Could Cry	Хэнк Уильямс
That’s All Right	Элвис Пресли
Up on the Roof	The Drifters
You Send Me	Сэм Кук
Honky Tonk Women	The Rolling Stones
Take Me to the River	Эл Грин
Crazy in Love	Бейонсе и Jay-Z
Shout (Parts 1 and 2)	The Isley Brothers
Go Your Own Way	Fleetwood Mac
I Want You Back	The Jackson 5
Stand by Me	Бен Кинг
House of the Rising Sun	The Animals
It’s a Man’s Man’s Man’s World	Джеймс Браун
Jumpin’ Jack Flash	The Rolling Stones
Will You Love Me Tomorrow	The Shirelles
Shake, Rattle and Roll	Биг Джо Тернер
Changes	Дэвид Боуи
Rock and Roll Music	Чак Берри
Born to Be Wild	Steppenwolf
Maggie May	Род Стюарт
With or Without You	U2
Who Do You Love?	Бо Диддли
Won’t Get Fooled Again	The Who
In the Midnight Hour	Уилсон Пикетт
While My Guitar Gently Weeps	The Beatles
Your Song	Элтон Джон
Eleanor Rigby	The Beatles
Family Affair	Sly & the Family Stone
I Saw Her Standing There	The Beatles
Kashmir	Led Zeppelin
All I Have to Do Is Dream	The Everly Brothers
Please, Please, Please	Джеймс Браун и Famous Flames
Purple Rain	Принс и The Revolution
I Wanna Be Sedated	The Ramones
Everyday People	Sly & the Family Stone
Rock Lobster	The B-52s(сингл), Крис Блэквелл (альбом)
Me and Bobby McGee	Дженис Джоплин
Lust for Life	Игги Поп
Cathy’s Clown	The Everly Brothers
Eight Miles High	The Byrds
Earth Angel	The Penguins
Foxey Lady	The Jimi Hendrix Experience
A Hard Day’s Night	The Beatles
Rave On	Бадди Холли и The Crickets
Proud Mary	Creedence Clearwater Revival
The Sound of Silence	Simon & Garfunkel
I Only Have Eyes for You	The Flamingos
Rock Around the Clock	Билл Хейли и The Comets
Moment of Surrender	U2
I’m Waiting for the Man	The Velvet Underground
Bring the Noise	Public Enemy
Folsom Prison Blues	Джонни Кэш	1956	▲ 1	Сэм Филлипс
I Can’t Stop Loving You	Рэй Чарльз
Nothing Compares 2 U	Шинейд О’Коннор’Коннор
Bohemian Rhapsody	Queen
Fast Car	Трэйси Чэпмен
Let’s Get It On	Марвин Гэй
Papa Was a Rollin’ Stone	The Temptations
Losing My Religion	R.E.M.
Both Sides, Now	Джони Митчелл
99 Problems	Jay-Z
Dream On	Aerosmith
Dancing Queen	ABBA
God Save the Queen	Sex Pistols
Paint It Black	The Rolling Stones
I Fought the Law	The Bobby Fuller Four
Don’t Worry Baby	The Beach Boys
Free Fallin’	Том Петти
September Gurls	Big Star
Love Will Tear Us Apart	Joy Division
Hey Ya!	Outkasté 3000
Green Onions	Booker T and the MG’s
Save the Last Dance for Me	The Drifters
The Thrill Is Gone	Би Би Кинг
Please Please Me	The Beatles
Desolation Row	Боб Дилан
Who’ll Stop the Rain	Creedence Clearwater Revival
I Never Loved a Man (The Way I Love You)	Арета Франклин
Back in Black	AC/DC
Stayin’ Alive	Bee Gees
Knockin’ on Heaven’s Door	Боб Дилан
Free Bird	Lynyrd Skynyrd
Rehab	Эми Уайнхаус
Wichita Lineman	Глен Кэмпбелл
There Goes My Baby	The Drifters
Peggy Sue	Бадди Холли
Sweet Child O' Mine	Guns N’ Roses
Maybe	The Chantels
Don’t Be Cruel	Элвис Пресли
Hey Joe	The Jimi Hendrix Experience
Flash Light	Parliament
Loser	Бек
Bizarre Love Triangle Order	1986 3 Order
Come Together	The Beatles
Positively 4th Street	Боб Дилан
Try a Little Tenderness	Отис Реддинг
Lean on Me	Билл Уизерс
Reach Out I’ll Be There	The Four Tops
Bye Bye Love	The Everly Brothers
Gloria	Them
In My Room	The Beach Boys
96 Tears	Question Mark & the Mysterians
Caroline, No	The Beach Boys
215
Rockin’ in the Free World	Нил Янг
Your Cheatin’ Heart	Хэнк Уильямс
Do You Believe in Magic	The Lovin’ Spoonful
Jolene	Долли Партон
Boom Boom	Джон Ли Хукер
Spoonful	Хаулин Вулф
Walk Away Renée	The Left Banke
Walk on the Wild Side	Лу Рид
Oh, Pretty Woman	Рой Орбисон
Dance to the Music	Sly & the Family Stone
Hoochie Coochie Man	Мадди Уотерс
Fire and Rain	Джеймс Тейлор
Should I Stay or Should I Go	The Clash
Good Times	Chic
Mannish Boy	Мадди Уотерс
Moondance	Ван Моррисон
Just Like a Woman	Боб Дилан
Sexual Healing	Марвин Гэй
Only the Lonely	Рой Орбисон
We Gotta Get out of This Place	The Animals
Paper Planes	M.I.A.
I’ll Feel a Whole Lot Better	The Byrds
Everyday	Бадди Холли
I Got a Woman	Рэй Чарльз
Planet Rock	Afrika Bambaataa & Soulsonic Force
I Fall to Pieces	Пэтси Клайн
Son of a Preacher Man	Дасти Спрингфилд
The Wanderer	Дион
Stand!	Sly & the Family Stone
Rocket Man	Элтон Джон
Love Shack	The B-52s
Gimme Some Lovin’	The Spencer Davis Group
(Your Love Keeps Lifting Me) Higher and Higher	Джеки Уилсон
The Night They Drove Old Dixie Down	The Band
Hot Fun in the Summertime	Sly & the Family Stone
Rapper’s Delight	The Sugarhill Gang
Chain of Fools	Арета Франклин
Paranoid	Black Sabbath
Money Honey	The Drifters
Mack the Knife	Бобби Дарин
All the Young Dudes	Mott the Hoople
Paranoid Android	Radiohead
Highway to Hell	AC/DC
Heart of Glass	Blondie
Mississippi	Боб Дилан
Wild Thing	The Troggs
I Can See for Miles	The Who
Oh, What a Night	The Dells
Hallelujah	Джефф Бакли
Higher Ground	Стиви Уандер
Ooo Baby Baby	The Miracles
He’s a Rebel	The Crystals
Sail Away	Рэнди Ньюмен
Walking in the Rain	The Ronettes
Tighten Up	Archie Bell and the Drells
Personality Crisis York Dolls
Sunday Bloody Sunday	U2
Jesus Walks	Канье Уэст
Roadrunner	The Modern Lovers
He Stopped Loving Her Today	Джордж Джонс
Sloop John B	The Beach Boys
Sweet Little Sixteen	Чак Берри
Something	The Beatles
Somebody to Love	Jefferson Airplane
Born in the U.S.A.	Брюс Спрингстин
I’ll Take You There	The Staple Singers
Ziggy Stardust	Дэвид Боуи
Pictures of You	The Cure
Chapel of Love	The Dixie Cups
Ain’t No Sunshine	Билл Уизерс
Seven Nation Army	The White Stripes
You Are the Sunshine of My Life	Стиви Уандер
Help Me	Джони Митчелл
Call Me	Blondie
(What’s So Funny ’Bout) Peace Love and Understanding?	Elvis Costello & the Attractions
Smokestack Lightning	Хаулин Вулф
Summer Babe	Pavement
Walk This Way	Run-DMC и Aerosmith
Money (That’s What I Want)	Барретт Стронг
Can’t Buy Me Love	The Beatles
Stan	Эминем и Дайдо45 King
She’s Not There	The Zombies
Train in Vain	The Clash
Tired of Being Alone	Эл Грин
Black Dog	Led Zeppelin
Street Fighting Man	The Rolling Stones
Get Up, Stand Up	Bob Marley & The Wailers
Heart of Gold	Нил Янг
Sign o’ the Times	Принс
One Way or Another	Blondie
Like a Prayer	Мадонна
One More Time	Daft Punk
Da Ya Think I’m Sexy?	Род Стюарт
Blue Eyes Crying in the Rain	Вилли Нельсон
Ruby Tuesday	The Rolling Stones
With a Little Help from My Friends	The Beatles
Say It Loud – I’m Black and I’m Proud	Джеймс Браун
That’s Entertainment	The Jam-Хэвен, The Jam
Why Do Fools Fall in Love	The Teenagers
Lonely Teardrops	Джеки Уилсон
What’s Love Got to Do with It	Тина Тёрнер
Iron Man	Black Sabbath
Wake Up Little Susie	The Everly Brothers
In Dreams	Рой Орбисон
I Put a Spell on You	Скримин Джей Хокинс
Comfortably Numb	Pink Floyd
Don’t Let Me Be Misunderstood	The Animals
Alison	Элвис Костелло
Wish You Were Here	Pink Floyd
Many Rivers to Cross	Джимми Клифф
School’s Out	Элис Купер
Take Me Out	Franz Ferdinand
Heartbreaker	Led Zeppelin
Cortez the Killer	Нил Янг
Fight the Power	Public Enemy
Dancing Barefoot	Patti Smith Group
Baby Love	The Supremes
Good Lovin’	The Young Rascals
Get Up (I Feel Like Being a) Sex Machine	Джеймс Браун
For Your Precious Love	Джерри Батлер и The Impressions
The End	The Doors
That’s the Way of the World	Earth, Wind and Fire
We Will Rock You	Queen
I Can’t Make You Love Me	Бонни Рэйтт
Subterranean Homesick Blues	Боб Дилан
Spirit in the Sky	Норман Гринбаум
Sweet Jane	The Velvet Underground
Wild Horses	The Rolling Stones
Beat It	Майкл Джексон
Beautiful Day	U2
Walk This Way	Aerosmith
Maybe I’m Amazed	Пол Маккартни
You Keep Me Hangin’ On	The Supremes
Baba O’Riley	The Who
The Harder They Come	Джимми Клифф
Runaround Sue	Дион
Jim Dandy	Лаверн Бейкер
Piece of My Heart	Big Brother and the Holding Company
La Bamba	Ричи Валенс
California Love	Dr. Dre и 2Pac
Candle in the Wind	Элтон Джон
That Lady (Part 1 and 2)	The Isley Brothers
Spanish Harlem	Бен Кинг
The Loco-Motion	Литл Ива
The Great Pretender	The Platters
All Shook Up	Элвис Пресли
Tears in Heaven	Эрик Клэптон
Watching the Detectives	Элвис Костелло
Bad Moon Rising	Creedence Clearwater Revival
Sweet Dreams (Are Made of This)	Eurythmics
Little Wing	The Jimi Hendrix Experience
Nowhere to Run	Martha and the Vandellas
Got My Mojo Working	Мадди Уотерс
Killing Me Softly with His Song	Роберта Флэк
All You Need Is Love	The Beatles
Complete Control	The Clash
The Letter	The Box Tops
Highway 61 Revisited	Боб Дилан
Unchained Melody	The Righteous Brothers
How Deep Is Your Love	Bee Gees
White Room	Cream
Personal Jesus	Depeche Mode
I’m a Man	Бо Диддли
The Wind Cries Mary	The Jimi Hendrix Experience
I Can’t Explain	The Who
Marquee Moon	Television
Wonderful World	Сэм Кук
Brown Eyed Handsome Man	Чак Берри
Another Brick in the Wall Part 2	Pink Floyd
Fake Plastic Trees	Radiohead
Maps	Yeah Yeah Yeahs
Hit the Road Jack	Рэй Чарльз
Pride (In the Name of Love)	U2
Radio Free Europe	R.E.M.
Goodbye Yellow Brick Road	Элтон Джон
Tell It Like It Is	Аарон Невилл
Bitter Sweet Symphony	The Verve«Youth» Гловер, Крис Поттер, The Verve
Whipping Post	The Allman Brothers Band
Ticket to Ride	The Beatles
Ohio	Crosby, Stills, Nash and Young
I Know You Got Soul	Eric B. & Rakim
Tiny Dancer	Элтон Джон
Roxanne	The Police
Just My Imagination (Running Away with Me)	The Temptations
Baby I Need Your Loving	The Four Tops
Summer in the City	The Lovin’ Spoonful
O-o-h Child	The Five Stairsteps
Can’t Help Falling in Love	Элвис Пресли
Remember (Walkin’ in the Sand)	The Shangri-Las
(Don’t Fear) The Reaper	Blue Oyster Cult
Thirteen	Big Star
Sweet Home Alabama	Lynyrd Skynyrd
Enter Sandman	Metallica
Tonight’s the Night	The Shirelles
Thank You (Falettinme Be Mice Elf Agin)	Sly & the Family Stone
C’mon Everybody	Эдди Кокран
Umbrella	Рианна и Jay-Z
Visions of Johanna	Боб Дилан
We’ve Only Just Begun	The Carpenters
In Bloom	Nirvana
Sweet Emotion	Aerosmith
Monkey Gone to Heaven	Pixies
I Feel Love	Донна Саммер
Ode to Billie Joe	Бобби Джентри
The Girl Can’t Help It	Литл Ричард
Young Blood	The Coasters
I Can’t Help Myself (Sugar Pie Honey Bunch)	The Four Tops
The Boys of Summer	Дон Хенли
Juicy	The Notorious B.I.G.
Fuck tha Police	N.W.A.
Suite: Judy Blue Eyes	Crosby, Stills & Nash
Nuthin’ But a “G” Thang	Dr. Dre
It’s Your Thing	The Isley Brothers
Piano Man	Билли Джоэл
Blue Suede Shoes	Элвис Пресли
William, It Was Really Nothing	The Smiths
American Idiot	Green Day
Tumbling Dice	The Rolling Stones
Smoke on the Water	Deep Purple
Year’s Day	U2
Everybody Needs Somebody to Love	Соломон Берк
(White Man) In Hammersmith Palais	The Clash
Ain’t That a Shame	Фэтс Домино
Midnight Train to Georgia	Gladys Knight and the Pips
Ramble On	Led Zeppelin
Mustang Sally	Уилсон Пикетт
Alone Again Or	Love
Beast of Burden	The Rolling Stones
Love Me Tender	Элвис Пресли
I Wanna Be Your Dog	The Stooges
Push It	Salt-N-Pepa
Pink Houses	John Cougar Mellencamp
In da Club	50 Cent
Come Go with Me	The Del-Vikings
I Shot the Sheriff	Боб Марли и The Wailers
I Got You Babe	Сонни и Шер
Come as You Are	Nirvana
Pressure Drop	Toots and the Maytals
Leader of the Pack	The Shangri-Las
Heroin	The Velvet Underground
Penny Lane	The Beatles
The Twist	Чабби Чекер
Cupid	Сэм Кук
Paradise City	Guns N’ Roses
My Sweet Lord	Джордж Харрисон
Sheena Is a Punk Rocker	Ramones
All Apologies	Nirvana
Soul Man	Сэм и Дейв
Kiss	Принс и The Revolution
Rollin’ Stone	Мадди Уотерс
Get Ur Freak On	Мисси Эллиотт
Big Pimpin’	Jay-Z
Respect Yourself	The Staple Singers
Rain	The Beatles
Standing in the Shadows of Love	The Four Tops
Surrender	Cheap Trick
Runaway	Дел Шеннон
Welcome to the Jungle	Guns N’ Roses
Into the Mystic	Ван Моррисон	1970	▲ 6	Ван Моррисон
Where Did Our Love Go	The Supremes
Do Right Woman, Do Right Man	Арета Франклин
How Soon Is Now?	The Smiths	1985	▲ 9	Джон Портер
Last Nite	The Strokes
I Want to Know What Love Is	Foreigner
Sabotage	Beastie Boys-младший
Super Freak	Рик Джеймс
Since U Been Gone	Келли Кларксон
White Rabbit	Jefferson Airplane
Cry Me a River	Джастин Тимберлейк
Lady Marmalade	Labelle
Young Americans	Дэвид Боуи
I’m Eighteen	Элис Купер
Just Like Heaven	The Cure
Under the Boardwalk	The Drifters
Clocks	Coldplay
I Love Rock ’n’ Roll	Joan Jett & the Blackhearts
I Will Survive	Глория Гейнор
Time to Pretend	MGMT
Ignition (Remix)	Ар Келли
Brown Sugar	The Rolling Stones
Running on Empty	Джексон Браун
The Rising	Брюс Спрингстин’Брайан
Miss You	The Rolling Stones
Buddy Holly	Weezer
Shop Around	The Miracles